w...cccccccc................w
w.....0.....0.....0.....0...w
w.....0.....0...............w
w....0.......0.....0........w
w...................0.......w
w.......0.....0.............w
w....0.......0.....0........w
w...............0.....0.....w
w...........................w
w.....0.....0...............w
w...........................w
w.....0.....0.....0.....0...w
w.....0.....0...............w
w....0.......0.....0........w
w...................0.......w
w.......0.....0.............w
w....0.......0.....0........w
w...............0.....0.....w
w...........................w
w.....0.....0...............w
w...........................w
I..................A........I