...........
...........
...........
.A.........
..........D
..........C
..........E