.I..A...I.
..PPPPPP..
..HHHHHH..
..........
..........
..........
..........
..........
..........
..........
..........
..111111..